|2A0|00|00|00|00|00|00|00|00| -
|5D0|85|02|50|2F|00|59|C0|00| - llave
|540|B0|00|FF|00|FF|00|20|00|
|5A0|7F|00|00|F0|00|00|00|2B|
|470|80|00|00|00|00|00|00|1F| luces, puertas, llave
|4A8|FE|7F|00|20|00|00|E0|41|
|570|  |  |  |07|00|94|05|00|
|320|00|02|12|01|00|02|00|80|
|288|11|9E|00|00|00|5D|88|00|
|588|00|40|80|00|00|10|00|00|
|723|  |04|03|01|00|00|00|00|
|0D0|  |  |B2|00|00|0C|1E|A0|
|488|69|00|00|80|A6|00|FF|B0|
|050|  |  |  |  |00|E0|30|D0| byte2: cinturones de seguridad
|48A|32|00|00|00|00|02|00|30|
|3A0|08|07|00|00|00|00|00|0F|
|1A0|00|00|00|00|00|FE|00|06|
|4A0|00|00|00|00|00|00|00|00|
|480|93|24|00|00|0C|80|00|3B|
|280|09|00|00|00|00|00|0C|00| byte7: acelerador y ermbrague, byte2 y byte0: pos. acelerador
|3D0|  |  |00|40|08|00|00|6B|
|728|  |04|03|01|00|00|00|00|
|729|  |04|03|01|00|00|00|00|
|727|  |04|01|01|00|00|00|00|
|35F|00|00|00|00|00|00|00|00|
|62B|80|20|02|40|0B|00|0F|40|
|550|00|00|00|00|00|00|00|00|
|380|00|6C|00|00|00|00|FE|19|
|000|  |  |  |  |  |  |  |  |
|000|  |  |  |  |  |  |  |  |
|000|  |  |  |  |  |  |  |  |
|000|  |  |  |  |  |  |  |  |